static const cBagSvg = 'assets/svgs/c-bag.svg';
static const cBikeSvg = 'assets/svgs/c-bike.svg';
static const cElectricSvg = 'assets/svgs/c-electric.svg';
static const cHomeSvg = 'assets/svgs/c-home.svg';
static const cKidsSvg = 'assets/svgs/c-kids.svg';
static const cManSvg = 'assets/svgs/c-man.svg';
static const cMoreSvg = 'assets/svgs/c-more.svg';
static const cWomanSvg = 'assets/svgs/c-woman.svg';
static const facebookSvg = 'assets/svgs/facebook.svg';
static const googleSvg = 'assets/svgs/google.svg';
static const iAddFriendSvg = 'assets/svgs/i-add-friend.svg';
static const iAddSvg = 'assets/svgs/i-add.svg';
static const iArrowBackSvg = 'assets/svgs/i-arrow-back.svg';
static const iArrowBottomSvg = 'assets/svgs/i-arrow-bottom.svg';
static const iArrowDownSvg = 'assets/svgs/i-arrow-down.svg';
static const iArrowLeftUpSvg = 'assets/svgs/i-arrow-left-up.svg';
static const iArrowRightSvg = 'assets/svgs/i-arrow-right.svg';
static const iCameraSvg = 'assets/svgs/i-camera.svg';
static const iCloseSvg = 'assets/svgs/i-close.svg';
static const iCouponSvg = 'assets/svgs/i-coupon.svg';
static const iIndicatorsSvg = 'assets/svgs/i-indicators.svg';
static const iLikeSvg = 'assets/svgs/i-like.svg';
static const iNotificationsSvg = 'assets/svgs/i-notifications.svg';
static const iSearchSvg = 'assets/svgs/i-search.svg';
static const iStarSvg = 'assets/svgs/i-star.svg';
static const iSubtractSvg = 'assets/svgs/i-subtract.svg';
static const iTrashSvg = 'assets/svgs/i-trash.svg';
static const navCartSvg = 'assets/svgs/nav-cart.svg';
static const navHomeSvg = 'assets/svgs/nav-home.svg';
static const navMessageSvg = 'assets/svgs/nav-message.svg';
static const navProfileSvg = 'assets/svgs/nav-profile.svg';
static const pCurrencySvg = 'assets/svgs/p-currency.svg';
static const pDeliverySvg = 'assets/svgs/p-delivery.svg';
static const pGiftSvg = 'assets/svgs/p-gift.svg';
static const pHomeSvg = 'assets/svgs/p-home.svg';
static const pNotificationsSvg = 'assets/svgs/p-notifications.svg';
static const pThemeSvg = 'assets/svgs/p-theme.svg';
static const pTranslateSvg = 'assets/svgs/p-translate.svg';
static const profileHeaderBackgroundSvg = 'assets/svgs/profile-header-background.svg';
